Aberdeen	SD	USA	ABR
Abilene	TX	USA	ABI
Akron	OH	USA	CAK
Alamosa	CO	USA	ALS
Albany	GA	USA	ABY
Albany	NY	USA	ALB
Albuquerque	NM	USA	ABQ
Alexandria	LA	USA	AEX
Allentown	PA	USA	ABE
Alliance	NE	USA	AIA
Alpena	MI	USA	APN
Altoona	PA	USA	AOO
Amarillo	TX	USA	AMA
Anchorage	AK	USA	ANC
Appleton	WI	USA	ATW
Asheville	NC	USA	AVL
Aspen	CO	USA	ASE
Athens	GA	USA	AHN
Atlanta	GA	USA	ATL
Augusta	GA	USA	AGS
Augusta	ME	USA	AUG
Austin	TX	USA	AUS
Bakersfield	CA	USA	BFL
Baltimore	MD	USA	BWI
Bangor	ME	USA	BGR
Barrow	AK	USA	BRW
Beaumont	TX	USA	BPT
Beckley	WV	USA	BKW
Bedford	MA	USA	BED
Bellingham	WA	USA	BLI
Bemidji	MN	USA	BJI
Bethel	AK	USA	BET
Bettles	AK	USA	BTT
Billings	MT	USA	BIL
Binghamton	NY	USA	BGM
Birmingham	AL	USA	BHM
Bismarck	ND	USA	BIS
Bloomington	IL	USA	BMI
Bloomington	IN	USA	BMG
Bluefield	WV	USA	BLF
Boise	ID	USA	BOI
Boston	MA	USA	BOS
Bozeman	MT	USA	BZN
Brookings	SD	USA	BKX
Brownsville	TX	USA	BRO
Brunswick	GA	USA	BQK
Buffalo	NY	USA	BUF
Burbank	CA	USA	BUR
Burlington	IA	USA	BRL
Burlington	MA	USA	BBF
Burlington	VT	USA	BTV
Butte	MT	USA	BTM
Carlsbad	CA	USA	CLD
Carlsbad	NM	USA	CNM
Casper	WY	USA	CPR
Champaign	IL	USA	CMI
Charleston	SC	USA	CHS
Charleston	WV	USA	CRW
Charlotte	NC	USA	CLT
Charlottesville	VA	USA	CHO
Chattanooga	TN	USA	CHA
Cheyenne	WY	USA	CYS
Chicago	IL	USA	MDW
Chicago	IL	USA	ORD
Chicago	IL	USA	CHI
Chico	CA	USA	CIC
Cincinnati	OH	USA	CVG
Clarksburg	WV	USA	CKB
Cleveland	OH	USA	CLE
Clovis	NM	USA	CVN
Cody	WY	USA	COD
Columbia	MO	USA	COU
Columbia	SC	USA	CAE
Columbus	GA	USA	CSG
Columbus	IN	USA	CLU
Columbus	MS	USA	GTR
Columbus	NE	USA	OLU
Columbus	OH	USA	CMH
Cordova	AK	USA	CDV
Dallas	TX	USA	DFW
Dallas	TX	USA	DAL
Dayton	OH	USA	DAY
Decatur	IL	USA	DEC
Denver	CO	USA	DEN
Detroit	MI	USA	DTW
Detroit	MI	USA	DTT
Dickinson	ND	USA	DIK
Dillingham	AK	USA	DLG
Dothan	AL	USA	DHN
Dubuque	IA	USA	DBQ
Duluth	MN	USA	DLH
Durango	CO	USA	DRO
Eek	AK	USA	EEK
Elko	NV	USA	EKO
Elmira	NY	USA	ELM
Enid	OK	USA	WDG
Erie	PA	USA	ERI
Escanaba	MI	USA	ESC
Eugene	OR	USA	EUG
Eureka	CA	USA	ACV
Evansville	IN	USA	EVV
Fairbanks	AK	USA	FAI
Fargo	ND	USA	FAR
Farmington	NM	USA	FMN
Fayetteville	AR	USA	XNA
Fayetteville	NC	USA	FAY
Flagstaff	AZ	USA	FLG
Flint	MI	USA	FNT
Florence	SC	USA	FLO
Fresno	CA	USA	FAT
Gainesville	FL	USA	GNV
Gillette	WY	USA	GCC
Glendive	MT	USA	GDV
Greenbrier	WV	USA	LWB
Greensboro	NC	USA	GSO
Greenville	MS	USA	GLH
Greenville	NC	USA	PGV
Greenville	SC	USA	GSP
Gulfport	MS	USA	GPT
Gunnison	CO	USA	GUC
Hagerstown	MD	USA	HGR
Hancock	MI	USA	CMX
Harlingen	TX	USA	HRL
Harrisburg	PA	USA	MDT
Harrison	AR	USA	HRO
Hartford	CT	USA	BDL
Havre	MT	USA	HVR
Hays	KS	USA	HYS
Helena	MT	USA	HLN
Hibbing	MN	USA	HIB
Hilo	HI	USA	Big
Hobbs	NM	USA	HOB
Homer	AK	USA	HOM
Houston	TX	USA	IAH
Houston	TX	USA	HOU
Houston	TX	USA	EFD
Huntington	WV	USA	HTS
Huntsville	AL	USA	HSV
Huron	SD	USA	HON
Hyannis	MA	USA	HYA
Indianapolis	IN	USA	IND
Inyokern	CA	USA	IYK
Ironwood	MI	USA	IWD
Islip	NY	USA	ISP
Ithaca	NY	USA	ITH
Jackson	MS	USA	JAN
Jackson	TN	USA	MKL
Jacksonville	FL	USA	JAX
Jacksonville	NC	USA	OAJ
Jamestown	ND	USA	JMS
Jamestown	NY	USA	JHW
Johnstown	PA	USA	JST
Jonesboro	AR	USA	JBR
Joplin	MO	USA	JLN
Juneau	AK	USA	JNU
Kailua-Kona	Hawaii	USA	Big
Kalamazoo	MI	USA	AZO
Kalispell	MT	USA	FCA
Kamuela	Hawaii	USA	Big
Kearney	NE	USA	EAR
Kenai	AK	USA	ENA
Ketchikan	AK	USA	KTN
Killeen	TX	USA	GRK
Kingman	AZ	USA	IGM
Kirksville	MO	USA	IRK
Knoxville	TN	USA	TYS
Kodiak	AK	USA	ADQ
Lafayette	LA	USA	LFT
Lancaster	PA	USA	LNS
Lansing	MI	USA	LAN
Laramie	WY	USA	LAR
Laredo	TX	USA	LRD
Latrobe	PA	USA	LBE
Laurel	MS	USA	PIB
Lawton	OK	USA	LAW
Lebanon	NH	USA	LEB
Lewiston	ID	USA	LWS
Lewiston	ME	USA	LEW
Lewistown	MT	USA	LWT
Lexington	KY	USA	LEX
Liberal	KS	USA	LBL
Lincoln	NE	USA	LNK
Longview	TX	USA	GGG
Louisville	KY	USA	SDF
Lubbock	TX	USA	LBB
Lynchburg	VA	USA	LYH
Macon	GA	USA	MCN
Madison	WI	USA	MSN
Manchester	NH	USA	MHT
Manhattan	KS	USA	MHK
Manistee	MI	USA	MBL
Marion	IL	USA	MWA
Marquette	MI	USA	MQT
Massena	NY	USA	MSS
McAllen	TX	USA	MFE
McCook	NE	USA	MCK
Medford	OR	USA	MFR
Melbourne	FL	USA	MLB
Memphis	TN	USA	MEM
Meridian	MS	USA	MEI
Miami	FL	USA	MIA
Midland	TX	USA	MAF
Milwaukee	WI	USA	MKE
Minneapolis	MN	USA	MSP
Minot	ND	USA	MOT
Missoula	MT	USA	MSO
Mobile	AL	USA	MOB
Modesto	CA	USA	MOD
Moline	IL	USA	MLI
Monroe	LA	USA	MLU
Monterey	CA	USA	MRY
Montgomery	AL	USA	MGM
Montrose	CO	USA	MTJ
Morgantown	WV	USA	MGW
Muskegon	MI	USA	MKG
Nantucket	MA	USA	ACK
Naples	FL	USA	APF
Nashville	TN	USA	BNA
Newark	NJ	USA	EWR
Newburgh	NY	USA	SWF
Nome	AK	USA	OME
Norfolk	VA	USA	ORF
Oakland	CA	USA	OAK
Ogdensburg	NY	USA	OGS
Omaha	NE	USA	OMA
Ontario	CA	USA	ONT
Orlando	FL	USA	MCO
Oshkosh	WI	USA	OSH
Owensboro	KY	USA	OWB
Oxnard	CA	USA	OXR
Paducah	KY	USA	PAH
Page	AZ	USA	PGA
Parkersburg	WV	USA	PKB
Pasco	WA	USA	PSC
Pellston	MI	USA	PLN
Pendleton	OR	USA	PDT
Pensacola	FL	USA	PNS
Peoria	IL	USA	PIA
Philadelphia	PA	USA	PHL
Phoenix	AZ	USA	PHX
Pierre	SD	USA	PIR
Pinehurst	NC	USA	SOP
Pittsburgh	PA	USA	PIT
Pocatello	ID	USA	PIH
Portland	ME	USA	PWM
Portland	OR	USA	PDX
Portsmouth	NH	USA	PSM
Prescott	AZ	USA	PRC
Providence	RI	USA	PVD
Provincetown	MA	USA	PVC
Pueblo	CO	USA	PUB
Pullman	WA	USA	PUW
Quincy	IL	USA	UIN
Raleigh	NC	USA	RDU
Redding	CA	USA	RDD
Redmond	OR	USA	RDM
Reno	NV	USA	RNO
Rhinelander	WI	USA	RHI
Richmond	VA	USA	RIC
Riverton	WY	USA	RIW
Roanoke	VA	USA	ROA
Rochester	MN	USA	RST
Rochester	NY	USA	ROC
Rockford	IL	USA	RFD
Rockland	ME	USA	RKD
Roswell	NM	USA	ROW
Rutland	VT	USA	RUT
Sacramento	CA	USA	SMF
Saginaw	MI	USA	MBS
Salina	KS	USA	SLN
Salisbury	MD	USA	SBY
Sarasota	FL	USA	SRQ
Savannah	GA	USA	SAV
Scottsbluff	NE	USA	BFF
Seattle	WA	USA	SEA
Sheridan	WY	USA	SHR
Shreveport	LA	USA	SHV
Sidney	MT	USA	SDY
Sitka	AK	USA	SIT
Skagway	AK	USA	SGY
Spokane	WA	USA	GEG
Springfield	IL	USA	SPI
Springfield	MA	USA	CEF
Springfield	MO	USA	SGF
Springfield	VT	USA	VSF
Syracuse	NY	USA	SYR
Tallahassee	FL	USA	TLH
Tampa	FL	USA	TPA
Telluride	CO	USA	TEX
Texarkana	AR	USA	TXK
Toledo	OH	USA	TOL
Eureka	KS	USA	TOP
Trenton	NJ	USA	TTN
Tucson	AZ	USA	TUS
Tulsa	OK	USA	TUL
Tupelo	MS	USA	TUP
Tyler	TX	USA	TYR
Unalakleet	AK	USA	UNK
Vail	CO	USA	EGE
Valdez	AK	USA	VDZ
Valdosta	GA	USA	VLD
Victoria	TX	USA	VCT
Visalia	CA	USA	VIS
Waco	TX	USA	ACT
Washington DC		USA	IAD
Washington DC		USA	DCA
Washington DC		USA	WAS
Waterloo	IA	USA	ALO
Watertown	NY	USA	ART
Watertown	SD	USA	ATY
Wausau	WI	USA	CWA
Wenatchee	WA	USA	EAT
Wichita	KS	USA	ICT
Wilkes-Barre	PA	USA	AVP
Williamsport	PA	USA	IPT
Williston	ND	USA	ISN
Wilmington	DE	USA	ILG
Wilmington	NC	USA	ILM
Worland	WY	USA	WRL
Wrangell	AK	USA	WRG
Yakima	WA	USA	YKM
Yakutat	AK	USA	YAK
Yuma	AZ	USA	YUM